#######
#G    #
#  #  #
#   S #
#######