#######
#G  # #
#  #  #
#    S#
#######
