#####################
## ##### # ### # # ##
## #               ##
## # # # # # # # # ##
#  #                #
## # # # ### # # # ##
## # #       # #    #
## # # # # # # # # ##
#  # #     S        #
## # # # # # # ######
#    #              #
#### # # # # # # # ##
#            #   # ##
## ### # # # # # # ##
#                #  #
## ### # # ### # # ##
##                  #
######G# ### # # # ##
#                   #
## # # # # # # # # ##
#####################